####################
# ^ ^ ^ ^ ^        #
#   ^             ^#
#         ^^       #
#   ^         ^^   #
#   ^             ^#
#         ^^       #
#   ^         ^^   #
#   ^             ^#
#   ^         ^^   #
####################
