#########################
    #          #        #
    #   ########         
    #   #          ######
 #  ############   #    #
 #          #      #  ###
 ####       #  #####  #
    #       #         #
#######################
            