#########################
    #
    #   ########
    #   #
 #  ############
 #          #
 ####       #
    #       #
#############
            